# @$.
 #####
 #.. #
###  #
# $  #
# $ ##
#@  #
#####
